Repos,Python,Svelte,JavaScript,TypeScript,HTML,CSS,Shell,Total,
anime-captcha,0,9520,390,1763,916,0,0,12589,
Auto-Language-Stats,0,0,2864,0,0,0,0,2864,
CarelessDev,0,0,0,0,0,0,0,0,
Evolution-Off-Aggression,3608,0,0,0,0,0,0,3608,
God-Bot,0,0,0,851,0,0,0,851,
made-for-nathan,0,1784,2082,105,393,890,0,5254,
mc-barrier-generator,0,0,844,0,0,0,333,1177,
Russian-Bot,0,0,574,1259,0,0,0,1833,
SIMP-Bot,20086,0,0,0,0,0,0,20086,
Total,23694,11304,6754,3978,1309,890,333,48262,
